
{
    "style_guide":[
        "This section is exclusively for commenting",
        "Rooms are always 9*9 tiles (excluding walls)",
        {
            "#":"Wall",
            " ":"Empty",
            "/":"Door",
            "p":"Player?",
            "c":"NPC",
            "o":"Object"
        },
        "Rooms are organised into the following categories",
        {
            "straight":"two doors on left and right sides",
            "corner":"two doors on left and top sides (corners can be rotated)"
        }
    ],
    "dead-end":[
        {
            "name":"open_1",
            "layout":[
                ["#","#","#","#","#","/","#","#","#","#","#"],
                ["#"," "," "," "," "," "," "," "," "," ","#"],
                ["#"," "," "," "," "," "," "," "," "," ","#"],
                ["#"," "," "," "," "," "," "," "," "," ","#"],
                ["#"," "," "," "," "," "," "," "," "," ","#"],
                ["#"," "," "," "," "," "," "," "," "," ","#"],
                ["#"," "," "," "," "," "," "," "," "," ","#"],
                ["#"," "," "," "," "," "," "," "," "," ","#"],
                ["#"," "," "," "," "," "," "," "," "," ","#"],
                ["#"," "," "," "," "," "," "," "," "," ","#"],
                ["#","#","#","#","#","#","#","#","#","#","#"]
            ]
        }
    ],
    "straight":[
        {
            "name":"open_1",
            "layout":[
                ["#","#","#","#","#","/","#","#","#","#","#"],
                ["#"," "," "," "," "," "," "," "," "," ","#"],
                ["#"," "," "," "," "," "," "," "," "," ","#"],
                ["#"," "," "," "," "," "," "," "," "," ","#"],
                ["#"," "," "," "," "," "," "," "," "," ","#"],
                ["#"," "," "," "," "," "," "," "," "," ","#"],
                ["#"," "," "," "," "," "," "," "," "," ","#"],
                ["#"," "," "," "," "," "," "," "," "," ","#"],
                ["#"," "," "," "," "," "," "," "," "," ","#"],
                ["#"," "," "," "," "," "," "," "," "," ","#"],
                ["#","#","#","#","#","/","#","#","#","#","#"]
            ]
        },
        {
            "name":"compressed_1",
            "layout":[
                ["#","#","#","#","#","/","#","#","#","#","#"],
                ["#","#","#"," "," "," "," "," ","#","#","#"],
                ["#","#","#"," "," "," "," "," ","#","#","#"],
                ["#","#","#"," "," "," "," "," ","#","#","#"],
                ["#","#","#"," "," "," "," "," ","#","#","#"],
                ["#","#","#"," "," "," "," "," ","#","#","#"],
                ["#","#","#"," "," "," "," "," ","#","#","#"],
                ["#","#","#"," "," "," "," "," ","#","#","#"],
                ["#","#","#"," "," "," "," "," ","#","#","#"],
                ["#","#","#"," "," "," "," "," ","#","#","#"],
                ["#","#","#","#","#","/","#","#","#","#","#"]
            ]
        }
    ],
    "corner":[
        {
            "name":"open_1",
            "layout":[
                ["#","#","#","#","#","/","#","#","#","#","#"],
                ["#"," "," "," "," "," "," "," "," "," ","#"],
                ["#"," "," "," "," "," "," "," "," "," ","#"],
                ["#"," "," "," "," "," "," "," "," "," ","#"],
                ["#"," "," "," "," "," "," "," "," "," ","#"],
                ["#"," "," "," "," "," "," "," "," "," ","/"],
                ["#"," "," "," "," "," "," "," "," "," ","#"],
                ["#"," "," "," "," "," "," "," "," "," ","#"],
                ["#"," "," "," "," "," "," "," "," "," ","#"],
                ["#"," "," "," "," "," "," "," "," "," ","#"],
                ["#","#","#","#","#","#","#","#","#","#","#"]
            ]
        }
    ],
    "3-way-junction":[
        {
            "name":"open_1",
            "layout":[
                ["#","#","#","#","#","/","#","#","#","#","#"],
                ["#"," "," "," "," "," "," "," "," "," ","#"],
                ["#"," "," "," "," "," "," "," "," "," ","#"],
                ["#"," "," "," "," "," "," "," "," "," ","#"],
                ["#"," "," "," "," "," "," "," "," "," ","#"],
                ["#"," "," "," "," "," "," "," "," "," ","/"],
                ["#"," "," "," "," "," "," "," "," "," ","#"],
                ["#"," "," "," "," "," "," "," "," "," ","#"],
                ["#"," "," "," "," "," "," "," "," "," ","#"],
                ["#"," "," "," "," "," "," "," "," "," ","#"],
                ["#","#","#","#","#","/","#","#","#","#","#"]
            ]
        }
    ],
    "4-way-junction":[
        {
            "name":"open_1",
            "layout":[
                ["#","#","#","#","#","/","#","#","#","#","#"],
                ["#"," "," "," "," "," "," "," "," "," ","#"],
                ["#"," "," "," "," "," "," "," "," "," ","#"],
                ["#"," "," "," "," "," "," "," "," "," ","#"],
                ["#"," "," "," "," "," "," "," "," "," ","#"],
                ["/"," "," "," "," "," "," "," "," "," ","/"],
                ["#"," "," "," "," "," "," "," "," "," ","#"],
                ["#"," "," "," "," "," "," "," "," "," ","#"],
                ["#"," "," "," "," "," "," "," "," "," ","#"],
                ["#"," "," "," "," "," "," "," "," "," ","#"],
                ["#","#","#","#","#","/","#","#","#","#","#"]
            ]
        },
        {
            "name":"compressed_1",
            "layout":[
                ["#","#","#","#","#","/","#","#","#","#","#"],
                ["#","#","#","#","#"," "," ","#","#","#","#"],
                ["#","#","#","#","#"," ","#","#","#","#","#"],
                ["#","#","#"," "," "," "," "," ","#","#","#"],
                ["#"," ","#"," "," "," "," "," ","#","#","#"],
                ["/"," "," "," "," "," "," "," "," "," ","/"],
                ["#","#","#"," "," "," "," "," ","#"," ","#"],
                ["#","#","#"," "," "," "," "," ","#","#","#"],
                ["#","#","#","#","#"," ","#","#","#","#","#"],
                ["#","#","#","#"," "," ","#","#","#","#","#"],
                ["#","#","#","#","#","/","#","#","#","#","#"]
            ]
        }
    ]
}
