
{
    "style_guide":[
        "This section is exclusively for commenting",
        "Rooms are always 9*9 tiles (excluding walls)",
        {
            "#":"Wall",
            " ":"Empty",
            "/":"Door"
        },
        "Rooms are organised into the following categories",
        {
            "straight":"two doors on left and right sides",
            "corner":"two doors on left and top sides (corners can be rotated)"
        }
    ],
    "dead-end":[
        {
            "name":"open_1",
            "layout":[
                ["#","#","#","#","#","/","#","#","#","#","#"],
                ["#"," "," "," "," "," "," "," "," "," ","#"],
                ["#"," "," "," "," "," "," "," "," "," ","#"],
                ["#"," "," "," "," "," "," "," "," "," ","#"],
                ["#"," "," "," "," "," "," "," "," "," ","#"],
                ["#"," "," "," "," "," "," "," "," "," ","#"],
                ["#"," "," "," "," "," "," "," "," "," ","#"],
                ["#"," "," "," "," "," "," "," "," "," ","#"],
                ["#"," "," "," "," "," "," "," "," "," ","#"],
                ["#"," "," "," "," "," "," "," "," "," ","#"],
                ["#","#","#","#","#","#","#","#","#","#","#"]
            ]
        },
        {
            "name":"library_1",
            "layout":[
                ["#","#","#","#","#","/","#","#","#","#","#"],
                ["#"," "," ","/"," "," "," ","/"," "," ","#"],
                ["#"," "," ","#"," "," "," ","#"," "," ","#"],
                ["#","/","#","#"," ","#"," ","#","#","/","#"],
                ["#"," "," "," "," ","#"," "," "," "," ","#"],
                ["#"," "," ","#","#","#","#","#"," "," ","#"],
                ["#"," "," "," "," ","#"," "," "," "," ","#"],
                ["#","/","#","#"," ","#"," ","#","#","/","#"],
                ["#"," "," ","#"," "," "," ","#"," "," ","#"],
                ["#"," "," ","/"," "," "," ","/"," "," ","#"],
                ["#","#","#","#","#","#","#","#","#","#","#"]
            ]
        },
        {
            "name":"space_invader_1",
            "layout":[
                ["#","#","#","#","#","/","#","#","#","#","#"],
                ["#"," "," "," "," "," "," "," "," "," ","#"],
                ["#"," "," "," "," "," "," "," "," "," ","#"],
                ["#"," "," "," ","#","#","#"," "," "," ","#"],
                ["#"," "," ","/"," ","#"," ","/"," "," ","#"],
                ["#"," "," ","#","#","#","#","#"," "," ","#"],
                ["#"," "," "," "," ","#"," "," "," "," ","#"],
                ["#"," "," ","#","/","#","/","#"," "," ","#"],
                ["#"," ","#","#"," ","#"," ","#","#"," ","#"],
                ["#"," ","/"," "," "," "," "," ","/"," ","#"],
                ["#","#","#","#","#","#","#","#","#","#","#"]
            ]
        },
        {
            "name":"space_invader_2",
            "layout":[
                ["#","#","#","#","#","/","#","#","#","#","#"],
                ["#"," "," "," "," "," "," "," "," "," ","#"],
                ["#"," "," "," "," ","#"," "," "," "," ","#"],
                ["#"," "," "," ","#","#","#"," "," "," ","#"],
                ["#"," ","#","/"," ","#"," ","/","#"," ","#"],
                ["#"," ","#","#","#","#","#","#","#"," ","#"],
                ["#"," "," ","#"," "," "," ","#"," "," ","#"],
                ["#"," ","#"," ","/","#","/"," ","#"," ","#"],
                ["#"," ","#","#"," ","#"," ","#","#"," ","#"],
                ["#"," ","/"," "," "," "," "," ","/"," ","#"],
                ["#","#","#","#","#","#","#","#","#","#","#"]
            ]
        }
    ],
    "straight":[
        {
            "name":"open_1",
            "layout":[
                ["#","#","#","#","#","/","#","#","#","#","#"],
                ["#"," "," "," "," "," "," "," "," "," ","#"],
                ["#"," "," "," "," "," "," "," "," "," ","#"],
                ["#"," "," "," "," "," "," "," "," "," ","#"],
                ["#"," "," "," "," "," "," "," "," "," ","#"],
                ["#"," "," "," "," "," "," "," "," "," ","#"],
                ["#"," "," "," "," "," "," "," "," "," ","#"],
                ["#"," "," "," "," "," "," "," "," "," ","#"],
                ["#"," "," "," "," "," "," "," "," "," ","#"],
                ["#"," "," "," "," "," "," "," "," "," ","#"],
                ["#","#","#","#","#","/","#","#","#","#","#"]
            ]
        },
        {
            "name":"compressed_1",
            "layout":[
                ["#","#","#","#","#","/","#","#","#","#","#"],
                ["#","#","#"," "," "," "," "," ","#","#","#"],
                ["#","#","#"," "," "," "," "," ","#","#","#"],
                ["#","#","#"," "," "," "," "," ","#","#","#"],
                ["#","#","#"," "," "," "," "," ","#","#","#"],
                ["#","#","#"," "," "," "," "," ","#","#","#"],
                ["#","#","#"," "," "," "," "," ","#","#","#"],
                ["#","#","#"," "," "," "," "," ","#","#","#"],
                ["#","#","#"," "," "," "," "," ","#","#","#"],
                ["#","#","#"," "," "," "," "," ","#","#","#"],
                ["#","#","#","#","#","/","#","#","#","#","#"]
            ]
        },
        {
            "name":"s_shape_1",
            "layout":[
                ["#","#","#","#","#","/","#","#","#","#","#"],
                ["#"," "," "," "," "," "," ","#","#","#","#"],
                ["#"," "," "," "," "," "," ","#","#","#","#"],
                ["#"," "," ","#","#","#","#","#","#","#","#"],
                ["#"," "," "," "," "," "," "," "," "," ","#"],
                ["#"," "," ","#","#","#","#","#"," "," ","#"],
                ["#"," "," "," "," "," "," "," "," "," ","#"],
                ["#","#","#","#","#","#","#","#"," "," ","#"],
                ["#","#","#"," "," "," "," "," "," "," ","#"],
                ["#","#","#"," "," "," "," "," "," "," ","#"],
                ["#","#","#","#","#","/","#","#","#","#","#"]
            ]
        }
    ],
    "corner":[
        {
            "name":"open_1",
            "layout":[
                ["#","#","#","#","#","/","#","#","#","#","#"],
                ["#"," "," "," "," "," "," "," "," "," ","#"],
                ["#"," "," "," "," "," "," "," "," "," ","#"],
                ["#"," "," "," "," "," "," "," "," "," ","#"],
                ["#"," "," "," "," "," "," "," "," "," ","#"],
                ["#"," "," "," "," "," "," "," "," "," ","/"],
                ["#"," "," "," "," "," "," "," "," "," ","#"],
                ["#"," "," "," "," "," "," "," "," "," ","#"],
                ["#"," "," "," "," "," "," "," "," "," ","#"],
                ["#"," "," "," "," "," "," "," "," "," ","#"],
                ["#","#","#","#","#","#","#","#","#","#","#"]
            ]
        },
        {
            "name":"sprial_1",
            "layout":[
                ["#","#","#","#","#","/","#","#","#","#","#"],
                ["#"," "," "," "," "," "," "," "," "," ","#"],
                ["#"," "," "," "," "," "," "," "," "," ","#"],
                ["#"," "," ","#","#","#"," ","#","#","#","#"],
                ["#"," "," ","#"," ","#"," ","#"," "," ","#"],
                ["#"," "," ","#"," ","#"," ","#"," "," ","/"],
                ["#"," "," ","#"," "," "," ","#"," "," ","#"],
                ["#"," "," ","#","#","#","#","#"," "," ","#"],
                ["#"," "," "," "," "," "," "," "," "," ","#"],
                ["#"," "," "," "," "," "," "," "," "," ","#"],
                ["#","#","#","#","#","#","#","#","#","#","#"]
            ]
        },
        {
            "name":"rigsby_1",
            "layout":[
                ["#","#","#","#","#","/","#","#","#","#","#"],
                ["#"," "," "," "," "," "," "," "," "," ","#"],
                ["#"," ","#","#"," "," "," "," "," "," ","#"],
                ["#","#"," ","#","#"," "," "," "," "," ","#"],
                ["#","#","#","#","#"," "," "," "," "," ","#"],
                ["#"," "," "," ","#","#"," "," ","/"," ","/"],
                ["#"," "," ","#","#","#"," "," ","/"," ","#"],
                ["#"," ","#","#"," ","#","#","#","#"," ","#"],
                ["#"," "," "," "," ","#","#"," "," "," ","#"],
                ["#"," "," "," ","#","#","#"," "," "," ","#"],
                ["#","#","#","#","#","#","#","#","#","#","#"]
            ]
        },
        {
            "name":"the_full_monty_1",
            "layout":[
                ["#","#","#","#","#","/","#","#","#","#","#"],
                ["#","#","#"," "," "," "," "," "," "," ","#"],
                ["#","#","#","#","#"," ","#","#","#"," ","#"],
                ["#"," "," "," "," "," "," "," "," "," ","#"],
                ["#"," "," ","#","#","#","#","#","#","#","#"],
                ["#"," "," "," "," "," "," ","#"," "," ","/"],
                ["#","#","#","#","#","#"," ","#"," "," ","#"],
                ["#"," "," "," "," "," "," ","#"," "," ","#"],
                ["#"," ","#","#","#","#","#","#"," "," ","#"],
                ["#"," "," "," "," "," "," "," "," "," ","#"],
                ["#","#","#","#","#","#","#","#","#","#","#"]
            ]
        }
    ],
    "3-way-junction":[
        {
            "name":"open_1",
            "layout":[
                ["#","#","#","#","#","/","#","#","#","#","#"],
                ["#"," "," "," "," "," "," "," "," "," ","#"],
                ["#"," "," "," "," "," "," "," "," "," ","#"],
                ["#"," "," "," "," "," "," "," "," "," ","#"],
                ["#"," "," "," "," "," "," "," "," "," ","#"],
                ["#"," "," "," "," "," "," "," "," "," ","/"],
                ["#"," "," "," "," "," "," "," "," "," ","#"],
                ["#"," "," "," "," "," "," "," "," "," ","#"],
                ["#"," "," "," "," "," "," "," "," "," ","#"],
                ["#"," "," "," "," "," "," "," "," "," ","#"],
                ["#","#","#","#","#","/","#","#","#","#","#"]
            ]
        },
        {
            "name":"open_2",
            "layout":[
                ["#","#","#","#","#","/","#","#","#","#","#"],
                ["#","#"," "," "," "," "," "," "," ","#","#"],
                ["#"," ","#"," "," "," "," "," ","#"," ","#"],
                ["#"," "," ","#","/","#","/","#"," "," ","#"],
                ["#"," "," ","/"," ","#"," ","/"," "," ","#"],
                ["#"," "," ","#","#","#","#","#"," "," ","/"],
                ["#"," "," ","/"," ","#"," ","/"," "," ","#"],
                ["#"," "," ","#","/","#","/","#"," "," ","#"],
                ["#"," ","#"," "," "," "," "," ","#"," ","#"],
                ["#","#"," "," "," "," "," "," "," ","#","#"],
                ["#","#","#","#","#","/","#","#","#","#","#"]
            ]
        },
        {
            "name":"hello_1",
            "layout":[
                ["#","#","#","#","#","/","#","#","#","#","#"],
                ["#"," "," "," "," "," "," "," "," "," ","#"],
                ["#"," ","#"," "," "," "," "," "," "," ","#"],
                ["#"," ","#"," "," "," ","#"," ","#"," ","#"],
                ["#"," ","#"," "," "," "," "," ","#"," ","#"],
                ["#"," ","#","#","#"," ","#"," ","#"," ","/"],
                ["#"," ","#"," ","#"," ","#"," ","#"," ","#"],
                ["#"," ","#"," ","#"," ","#"," "," "," ","#"],
                ["#"," ","#"," ","#"," ","#"," ","#"," ","#"],
                ["#"," "," "," "," "," "," "," "," "," ","#"],
                ["#","#","#","#","#","/","#","#","#","#","#"]
            ]
        }
    ],
    "4-way-junction":[
        {
            "name":"open_1",
            "layout":[
                ["#","#","#","#","#","/","#","#","#","#","#"],
                ["#"," "," "," "," "," "," "," "," "," ","#"],
                ["#"," "," "," "," "," "," "," "," "," ","#"],
                ["#"," "," "," "," "," "," "," "," "," ","#"],
                ["#"," "," "," "," "," "," "," "," "," ","#"],
                ["/"," "," "," "," "," "," "," "," "," ","/"],
                ["#"," "," "," "," "," "," "," "," "," ","#"],
                ["#"," "," "," "," "," "," "," "," "," ","#"],
                ["#"," "," "," "," "," "," "," "," "," ","#"],
                ["#"," "," "," "," "," "," "," "," "," ","#"],
                ["#","#","#","#","#","/","#","#","#","#","#"]
            ]
        },
        {
            "name":"compressed_1",
            "layout":[
                ["#","#","#","#","#","/","#","#","#","#","#"],
                ["#","#","#","#"," "," "," ","#","#","#","#"],
                ["#","#","#","#"," "," "," ","#","#","#","#"],
                ["#","#","#","#"," "," "," ","#","#","#","#"],
                ["#"," "," "," "," "," "," "," "," "," ","#"],
                ["/"," "," "," "," "," "," "," "," "," ","/"],
                ["#"," "," "," "," "," "," "," "," "," ","#"],
                ["#","#","#","#"," "," "," ","#","#","#","#"],
                ["#","#","#","#"," "," "," ","#","#","#","#"],
                ["#","#","#","#"," "," "," ","#","#","#","#"],
                ["#","#","#","#","#","/","#","#","#","#","#"]
            ]
        },
        {
            "name":"atomic_1",
            "layout":[
                ["#","#","#","#","#","/","#","#","#","#","#"],
                ["#"," "," "," "," "," "," "," "," "," ","#"],
                ["#"," ","#","#"," "," "," ","#","#"," ","#"],
                ["#"," ","#","#"," "," "," ","#","#"," ","#"],
                ["#"," "," "," ","#","#","#"," "," "," ","#"],
                ["/"," "," "," ","#"," ","#"," "," "," ","/"],
                ["#"," "," "," ","#","#","#"," "," "," ","#"],
                ["#"," ","#","#"," "," "," ","#","#"," ","#"],
                ["#"," ","#","#"," "," "," ","#","#"," ","#"],
                ["#"," "," "," "," "," "," "," "," "," ","#"],
                ["#","#","#","#","#","/","#","#","#","#","#"]
            ]
        }
    ]
}
